2,1,1,1,3,X,X,X,X
1,1,4,5,6,1,X,X,X
1,2,3,1,4,1,1,X,X
1,3,1,1,5,1,4,1,X
2,3,4,5,6,2,3,4,5
X,1,1,1,2,1,1,1,1
X,X,1,3,4,1,1,1,1
X,X,X,1,3,1,1,1,1
X,X,X,X,5,1,1,1,1
