1,1,1,1,1,X,X,X,X
1,2,2,2,2,2,X,X,X
1,2,3,3,3,2,1,X,X
1,2,3,4,4,3,2,1,X
1,2,3,4,5,4,3,2,1
X,1,2,3,4,4,3,2,1
X,X,1,2,3,3,3,2,1
X,X,X,1,2,2,2,2,1
X,X,X,X,1,1,1,1,1