1,2,3,1,2,X,X,X,X
3,1,2,3,2,1,X,X,X
1,3,1,2,3,1,2,X,X
6,2,6,1,6,3,6,2,X
6,6,6,6,6,6,6,6,6
X,6,6,6,6,6,6,6,6
X,X,4,6,5,6,4,6,5
X,X,X,5,4,5,4,5,4
X,X,X,X,5,4,4,5,4
