1,1,1,3,3,X,X,X,X
1,1,1,3,3,3,X,X,X
1,1,1,3,3,3,3,X,X
1,1,1,1,3,3,3,3,X
1,1,2,2,3,3,4,4,4
X,2,2,2,2,4,4,4,4
X,X,2,2,2,4,4,4,4
X,X,X,2,2,2,4,4,4
X,X,X,X,2,2,2,4,4
