1,1,1,1,1,X,X,X,X
2,2,2,2,2,2,X,X,X
3,3,3,3,3,3,3,X,X
4,4,4,4,4,4,4,4,X
5,5,5,5,5,5,5,5,5
X,6,6,6,6,6,6,6,6
X,X,1,1,1,1,1,1,1
X,X,X,2,2,2,2,2,2
X,X,X,X,3,3,3,3,3
