6,4,4,2,5,6,3,X,X,X,X,X,X
6,4,4,2,5,6,3,6,X,X,X,X,X
5,6,4,2,5,6,3,6,1,X,X,X,X
3,5,6,4,2,5,3,6,1,4,X,X,X
2,3,5,6,4,2,3,6,1,4,3,X,X
3,2,3,5,6,4,3,6,1,4,3,1,X
2,2,2,2,2,2,2,1,2,2,2,2,2
X,6,5,1,3,4,3,5,4,3,5,4,6
X,X,5,1,3,4,3,6,5,4,3,5,4
X,X,X,1,3,4,3,6,4,5,4,3,5
X,X,X,X,3,4,3,6,4,4,5,4,3
X,X,X,X,X,4,3,6,4,4,5,4,4
X,X,X,X,X,X,4,3,6,4,4,5,4