1,2,3,4,5,X,X,X,X
6,6,5,4,3,2,X,X,X
1,1,2,3,4,5,6,X,X
6,5,4,3,2,1,1,2,X
3,4,5,6,6,5,4,3,2
X,1,1,2,3,4,5,6,6
X,X,5,4,3,2,1,1,2
X,X,X,3,4,5,6,6,5
X,X,X,X,4,3,2,1,1
