1,2,3,4,5,X,X,X,X
4,3,2,1,2,5,X,X,X
1,2,3,4,5,1,2,X,X
6,6,6,6,6,6,6,6,X
6,6,6,6,6,6,6,6,6
X,6,6,6,6,6,6,6,6
X,X,1,5,2,4,3,2,4
X,X,X,3,2,1,2,5,4
X,X,X,X,5,4,3,2,1
