1,1,1,1,6,X,X,X,X
2,1,1,1,6,6,X,X,X
2,2,1,1,6,6,6,X,X
2,2,2,1,6,6,6,6,X
2,2,2,2,1,5,5,5,5
X,3,3,3,3,4,5,5,5
X,X,3,3,3,4,4,5,5
X,X,X,3,3,4,4,4,5
X,X,X,X,3,4,4,4,4
