1,1,1,1,2,X,X,X,X
1,1,1,1,6,3,X,X,X
1,1,1,1,4,5,3,X,X
1,1,1,1,2,1,3,3,X
2,6,3,2,6,3,2,6,3
X,4,5,5,4,5,4,4,5
X,X,1,5,5,1,4,4,1
X,X,X,2,6,3,2,6,3
X,X,X,X,4,5,1,4,5
